1111111111111111111111111
100000110000001000F0000C1
101F1C111110001000001E111
10111100000000100111101F1
10000001111110000100C0111
1111111001000110010F01001
1P1C00100001C110010010011
10110010111110000001001C1
1001001000100000000001101
1011011000010111110010001
100001110F110000010100111
10RICARDO00100000100001C1
10000000000000000100F0001
1111111111111111111111111
