1111111111
1E10000001
11C1000F01
1P00000001
1111111111