111111111111111
10000C000P00001
1000E0000000001
111111110000001
100000010000001
111000000100C11
100000010000001
100000011000111
100C00000000001
111111111111111