111111111111111111111
10E001000100000C10111
100P01000100000E00011
111111111111111111111