1111111111111111
100000C10P000001
1000101E11100001
1001C10000000001
100000000000C001
1111111111111111