11111111111111111111
1000010C010000001E01
10000100010000001001
1000110000010000C001
10011100001100111111
100P0000111000000001
11111111111111111111