1111111111111111
100000C00P000001
1000101E11100001
1000C00000000001
100000000000C001
1111111111111111