1111111111111111
100000C100000001
1000101E11100001
1001C10000000001
100000000000C1P1
1111111111111111