1111111111111111
10000C000P000001
1000E00000000001
1111111100000001
1000000100000001
111000000100C101
1000000100000001
1000000110001101
100C000000100001
1111111111111111