111111111111111111111
10E0010001000C0010111
100P01000100000010011
111111111111111111111