1111111111111111111111111
10000011000000100000000C1
10101C111110001000001E111
1011110000000010011110101
10000001111110000100C0111
1111111001000100010001001
1P1C00100001C110010010011
10110010111110000001001C1
1001001000100000000001101
1011011000010111110010001
1000011100110000010100111
10011100000100000100001C1
1000000000000000010000001
1111111111111111111111111