1111111111
10000C0001
10C0000001
10E0000001
1100000P11
1111111111