1111111111
100C0C0001
1000000001
10EF000001
10000F0P01
1111111111